1111111111111111111111111111111111111111111
10P00C000C00000C000000000000000000000000011
1000111000001111000000000011110000011110001
100010100000000100000C000000010000010010001
100000100000111100000C000011110000001110001
1010000000000000000000000000000000111000111
10100000111000000010100100100C0C00000000E01
101000000000C0000000000C0000000000000000111
1111111111111111111111111111111111111111111
