1111111111111111111111111111111111
1000000000P00000C00000C00000000001
1010010100100000101001000000010101
1010010010101010001001000000010101
100101000C00C000010110101010000E01
1000001001011010100100010000001111
1111111111111111111111111111111111
