1111111111111111111111111111111111111111111
1P00BC000C00000C000000000000000000000000011
1001110000011110000000000111100B00111100001
100010100000000100000C000000010000010010001
100010100000111100000C000011110000000010001
1C1000100000000100000C000000010000000010001
1B00000000000000000000000000000000000010001
1000000000000000000000000000000000000000001
10000000000000000B0000B00000000000000000001
100000000000000000000000000000000000000C001
1000000000000000000000000000000000000000001
10000000B0000000000000000000000000000000001
10100000000000000000000000000B0000000000001
10100000000000000B0000000000000000000000001
101000000000000000000000000000C000000000001
101000000000C0000000000C0000000000000000EC1
1111111111111111111111111111111111111111111