1111111111111111111111111111111111111111111
1P000C000C00000C000000000000000000000000011
1001111000011111000000000111110000111110001
100100100000000100000C000000010000100010001
100000100000111100000C000011110000000010001
1C0000100000000100000C000000010000000010001
1000011100001111000000000011110000000010001
1000000000000000000000000000000000000000001
10000C0000000000000000000000000000000000001
100000000000000000000000000000000000000C001
1000000000000000000000000000000000000000001
1000000000000000000000000000000000000000001
1010000000000011111111111111110000000000001
1010000000000000000000000000000000000000001
101000000000000000000000000000C000000000101
101000000000C0000000000C0000000000000000EC1
1111111111111111111111111111111111111111111
