1111111111111111111111111111111111111111111
100P00100000001000C00010B00000C000000100001
10000C100000000000B000100000000000000000001
1000B0000C000010000C0000000000C00000010C001
100000100000B00000000E100000000000000100001
1111111111111111111111111111111111111111111