1111111111111111111111111111111111111111111
1P000C000C00000C0B0000000000000000000000011
1001111000011111000000000111110000111110001
100100100000000100000C000000010000100010001
100000100000111100000C000011110000000010001
1C00001000000001000B0C000000010000000010001
1000011100001111000000000011110000000010001
100000000000000000000000B000000000000000001
10000C000000000000B000000000000000000000001
1000B0000000000000000000000000000000000C001
100000000000B000000000000000000000000000001
1000000000B00000000000000000000000000000001
1010000000111111111111111111100000000000001
10100000B0000000B00000000000000000000000001
101000000000000000000000000000C000000000101
101000000000C0000000000C0000000000000000EC1
1111111111111111111111111111111111111111111