11111111111
1000PE00001
10000C00001
11111100001
10000000001
10000C0C0C1
1000B000001
10000B00001
10000000001
11111111111